-------------
------G------
-----O#O-----
---VRR*RRV---
--GBGYVYGBG--
---YGO%OGY---
---G-----G---
--B*Y---Y*B--
---YR---RY---
-------------
-------------
-------------
-------------
-------------
-------------