---------------------
-XXX-I#II------------
---XXXX-III----------
-----XXX--III-ZZZZZZ-
----XXX--II*III-ZZZZ-
--XXXX-III---III-----
-X*X-IIII-----I%II---
---------------------
---------------------
---------------------