-------------------
-------------------
----VVGGGRGGGVV----
-----GBYY#YYBG-----
-----GBVY*YVBG-----
-----RGGGGGGGRY----
---YRY-------YRY---
--YRY---------YRY--
-R%Y-----------Y*R-
-BRR-----------RRB-
-------------------
-------------------
-------------------
-------------------